01000000
01001000
00001000
00100000
00100100
00100000
00000100
00010000
